Position,Team,Played,Won,Drawn,Lost,For,Against,GD,Points
1,Man City,35,25,5,5,72,26,46,80
2,Man Utd,35,20,10,5,68,38,30,70
3,Leicester,36,20,6,10,65,44,21,66
4,Chelsea,36,18,10,8,55,33,22,64
5,West Ham,35,17,7,11,55,45,10,58
6,Liverpool,34,16,9,9,57,39,18,57
7,Tottenham,35,16,8,11,61,41,20,56
8,Arsenal,36,16,7,13,50,38,12,55
9,Everton,34,16,7,11,46,42,4,55
10,Leeds,35,15,5,15,53,53,0,50
11,Aston Villa,34,14,6,14,49,41,8,48
12,Wolves,35,12,9,14,35,47,-12,45
13,Crystal Palace,35,11,8,16,37,59,-22,41
14,Southampton,35,11,7,17,44,62,-18,40
15,Burnley,35,10,9,16,33,47,-14,39
16,Newcastle,35,10,9,16,40,58,-18,39
17,Brighton,35,8,13,14,36,41,-5,37
18,Fulham,35,5,12,18,25,47,-22,27
19,West Brom,35,5,11,19,32,68,-36,26
20,Sheff Utd,35,5,2,28,18,62,-44,17
